##############
#  ##############  
#    A          #
#  #### ###### ## 
#               #
#  ############## 
#           B   #
#################