##############
#  ##############  
#A              #
############    # 
#               #
#  ############## 
#               #
#################