##############
#  ##############  
#A              #
################# 
#               #
#  ############## 
#           B   #
#################