##############
#  ##############  
#               #
############    # 
#               #
#  ############## 
#           B   #
#################